111111111111111111111111111
1000000000010000C0000000001
100000P00001000000000000001
100000000001110000000000001
10000000111110000000000C001
10000C000000000000000000001
100000000000010000000000001
100100000010C10000000C00001
1001000000100100000000E0001
111111111111111111111111111