111111111111
1C0000110001
1001E00C0010
101000C00P01
111111111111