11111111
10E00001
10P00001
10000001
1000C001
10010001
10C00001
11111111