111111111111
1C0000110001
1001000C0011
101000C00P01
111111111111